S . . # . . . . . .
# # . # . # # # # .
. . . . . . . . # .
. # # # # # # . # .
. . . . . . # . . .
. # # # # . # # # .
. . . . # . . . . .
# # . . # # # # # .
. . . . . . . G . .
. # # # # # # # # #
